560001555555555555555555555
590007888888888888888888885
600000000000000000000000004
600000000000000000000000004
6000000000000000000000ABBB5
600000000000000000000000004
600000000000000000000000004
60000000000000000000AC00004
522222222300000000000000004
555555555600000000000000004
58888888890000000ABBC000004
600000000000000000000000004
600000000000000000000000004
600000000000000000000000004
6000ABBBBC00000000000000004
600000000000000000000000004
600000000000000000000000004
600000000000000000000000004
600000000000000000000000004
600000000001222300000000004
600000000004555600000000004
600000000004555600000000004
600000000004555522300000004
600000000004555555600000004
600000122225555555600000004
600000455555555555522222224
600000788888888888888888884
600000000000000000000000004
600000000000000000000000004
600000000000000000000000004
622230000000000000000000004
655560000000000000000000004
655560000000000000000000004
655560000000000000000000004
655560000000000000000000004
655560000000000000000000004
655560000000000000000000004
655560000000000000000000004
655552223000000000000000004
655555556000000000012300004
655555555223000000045600004
655555555556000000045600004
655555555555222222255600004
655555555555555555555600004
655555555555555555555600004
688888888888888888888900004
600000000000000000000000004
600000000000000000000000004
600000000000000000000000004
600000012300000000000000004
600000078900000000000000004
600000000000000000000000004
6000000000012300000000ABC04
600000000007890000000000004
600000000000000000000000004
600000000000000000000000004
600000000000000000001222225
600000000000000000004555555
600000122222222222225555555
600000455555555555555555555
600000788888888888888888885
600000000000000000000000004
600000000000000000000000004
600000000000000000000000004
600000000000000000000000004
60ABC0000000000000000000004
600000000000000000000000004
600000000012230001230000004
600000000045560004560000004
600000000045560004560000004
622222222255560004552222224
655555555555560004555555554
655555555555560004555555554
655555555555560004555555554
655555555555560004555555554
655555555555560004555555554
655555555555560004555555554
655555555555590004555555554
655555555555600004555555554
655555555555600004555555554
655555555555600004555555554
655555555555900004555555554
655555555556000004555555554
655555555556000004555555554
655555555556000004555555554
655555555559000015555555554
655555555560000155555555554
655555555560000455555555554
655555555590000455555555554
655555555900001555555555554
655555556000004555555555554
655555556000004555555555554
655555559000004555555555554
655555560000125555555555554
655555560000455555555555554
655555560000755555555555554
655555553000045555555555554
655555556000045555555555554
655555556000075555555555554
655555555300004555555555554
655555555600004555555555554
655555555600007555555555554
655555555530000455555555554
655555555560000455555555554
655555555560000755555555554
655555555553000045555555554
655555555556000045555555554
655555555556000075555555554
655555555555300004555555554
655555555555600004555555554
655555555555600004555555554
655555555555600007555555554
655555555555530000455555554
655555555555560000455555554
655555555555560000755555554
655555555555553000045555554
655555555555556000045555554
655555555555556000075555554
655555555555555300004555554
655555555555555600004555554
655555555555555600004555554
655555555555555600004555554
655555555555555600004555554
655555555555555600004555554
655555555555555600004555554
655555555555555600004555554
655555555555555600004555554
655555555555555600004555554
655555555555555600004555554
655555555555555600004555554
